火箭	rockets
鹈鹕	pelicans
马刺	spurs
独行侠	mavericks
灰熊	grizzlies
勇士	warriors
快船	clippers
湖人	lakers
国王	kings
太阳	suns
开拓者	blazers
雷霆	thunder
爵士	jazz
森林狼	timberwolves
掘金	nuggets
猛龙	raptors
凯尔特人	celtics
76人	76ers
尼克斯	knicks
篮网	nets
热火	heat
奇才	wizards
黄蜂	hornets
魔术	magic
老鹰	hawks
骑士	cavaliers
步行者	pacers
雄鹿	bucks
活塞	pistons
公牛	bulls
